Hallway
44 54
-1 -1 -1 -1 -1 -1 -1 -1 -1 -1 4 -1 -1 -1 -1 -1 -1 -1 -1 -1 -1 -1 -1 -1 -1 -1 -1 -1 -1 -1 4 4 4 4 4 4 4 4 4 4 4 4 4 4 4 4 -1 -1 -1 -1 -1 -1 -1 -1
-1 -1 -1 -1 -1 -1 -1 -1 -1 3 0 1 -1 -1 -1 -1 -1 -1 -1 -1 -1 -1 -1 -1 -1 -1 -1 -1 -1 3 0 0 0 0 0 0 0 0 0 0 0 0 0 0 0 0 1 -1 -1 -1 -1 -1 -1 -1
-1 -1 -1 -1 -1 -1 -1 -1 -1 3 0 1 -1 -1 -1 -1 -1 -1 -1 -1 -1 -1 -1 -1 -1 -1 -1 -1 -1 3 0 6 2 2 2 2 2 2 2 2 2 2 2 2 8 0 1 -1 -1 -1 -1 -1 -1 -1
-1 -1 -1 -1 -1 -1 -1 -1 -1 3 0 1 -1 -1 -1 -1 -1 -1 -1 -1 -1 -1 -1 -1 -1 -1 -1 -1 -1 3 0 1 -1 -1 -1 -1 -1 -1 -1 -1 -1 -1 -1 -1 3 0 1 -1 -1 -1 -1 -1 -1 -1
-1 -1 -1 -1 -1 -1 -1 -1 -1 3 0 1 -1 -1 -1 -1 -1 -1 -1 -1 -1 -1 -1 -1 -1 -1 -1 -1 -1 3 0 1 -1 -1 -1 -1 -1 -1 -1 -1 -1 -1 -1 -1 3 0 1 -1 -1 -1 -1 -1 -1 -1
-1 -1 -1 -1 -1 -1 -1 -1 -1 3 0 1 -1 -1 -1 -1 -1 -1 -1 -1 -1 -1 -1 -1 -1 -1 -1 -1 -1 3 0 1 -1 -1 -1 -1 -1 -1 -1 -1 -1 -1 -1 -1 13 0 1 -1 -1 -1 -1 -1 -1 -1
-1 -1 -1 -1 -1 -1 -1 -1 -1 3 0 1 -1 -1 -1 -1 -1 -1 -1 -1 -1 -1 -1 -1 -1 -1 -1 -1 -1 3 0 1 -1 -1 -1 -1 -1 -1 -1 -1 -1 -1 -1 -1 3 0 1 -1 -1 -1 -1 -1 -1 -1
-1 -1 -1 -1 -1 -1 -1 -1 -1 3 0 12 -1 -1 -1 -1 -1 -1 -1 -1 -1 -1 -1 -1 -1 -1 -1 -1 -1 13 0 1 -1 -1 -1 -1 -1 -1 -1 -1 -1 -1 -1 -1 3 0 1 -1 -1 -1 -1 -1 -1 -1
-1 -1 -1 -1 -1 -1 -1 -1 -1 3 0 1 -1 -1 -1 -1 -1 -1 -1 -1 -1 -1 -1 -1 -1 -1 -1 -1 -1 3 0 1 -1 -1 -1 -1 -1 -1 -1 -1 -1 -1 -1 -1 3 0 1 -1 -1 -1 -1 -1 -1 -1
-1 -1 -1 -1 -1 -1 -1 -1 -1 3 0 1 -1 -1 -1 -1 -1 -1 -1 -1 -1 -1 -1 -1 -1 -1 -1 -1 -1 3 0 1 -1 -1 -1 -1 -1 -1 -1 -1 -1 -1 -1 -1 3 0 1 -1 -1 -1 -1 -1 -1 -1
-1 -1 -1 -1 -1 -1 -1 -1 -1 13 0 1 -1 -1 -1 -1 -1 -1 -1 -1 -1 -1 -1 -1 -1 -1 -1 -1 -1 3 0 1 -1 -1 -1 -1 -1 -1 -1 -1 -1 -1 -1 -1 3 0 1 -1 -1 -1 -1 -1 -1 -1
-1 -1 -1 -1 -1 -1 -1 -1 -1 3 0 1 -1 -1 -1 -1 -1 -1 -1 -1 -1 -1 -1 -1 -1 -1 -1 -1 -1 3 0 1 -1 -1 -1 -1 -1 -1 -1 -1 -1 -1 -1 -1 3 0 1 -1 -1 -1 -1 -1 -1 -1
-1 -1 -1 -1 -1 -1 -1 -1 -1 3 0 1 -1 -1 -1 -1 -1 -1 -1 -1 -1 -1 -1 -1 -1 -1 -1 -1 -1 3 0 1 -1 -1 -1 -1 -1 -1 -1 -1 -1 -1 -1 -1 3 0 1 -1 -1 -1 -1 -1 -1 -1
-1 -1 -1 -1 -1 -1 -1 -1 -1 3 0 7 4 4 4 4 4 4 4 4 4 4 4 4 4 4 4 4 4 9 0 12 -1 -1 -1 -1 -1 -1 -1 -1 -1 -1 -1 -1 3 0 1 -1 -1 -1 -1 -1 -1 -1											
-1 -1 -1 -1 -1 -1 -1 -1 -1 3 0 0 0 0 0 0 0 0 0 0 0 0 0 0 0 0 0 0 0 0 0 1 -1 -1 -1 -1 -1 -1 -1 -1 -1 -1 -1 -1 3 0 1 -1 -1 -1 -1 -1 -1 -1											
-1 -1 -1 -1 -1 -1 -1 -1 -1 3 0 6 2 2 2 8 0 6 2 2 2 2 10 2 2 2 2 2 2 8 0 1 -1 -1 -1 -1 -1 -1 -1 -1 -1 -1 -1 -1 3 0 1 -1 -1 -1 -1 -1 -1 -1											
-1 -1 -1 -1 -1 -1 -1 -1 -1 3 0 1 -1 -1 -1 3 0 1 -1 -1 -1 -1 -1 -1 -1 -1 -1 -1 -1 3 0 1 -1 -1 -1 -1 -1 -1 -1 -1 -1 -1 -1 -1 3 0 1 -1 -1 -1 -1 -1 -1 -1											
-1 -1 -1 -1 -1 5 5 5 5 9 0 1 -1 -1 -1 3 0 1 -1 -1 -1 -1 -1 -1 -1 -1 -1 -1 -1 3 0 1 -1 -1 -1 -1 -1 -1 -1 -1 -1 -1 -1 -1 3 0 1 -1 -1 -1 -1 -1 -1 -1											
-1 -1 -1 -1 -1 5 5 5 21 0 0 1 -1 -1 -1 3 0 7 4 4 4 4 4 -1 -1 -1 -1 -1 -1 3 0 1 -1 -1 -1 -1 -1 -1 -1 -1 -1 -1 -1 -1 3 0 7 5 5 5 5 -1 -1 -1											
-1 -1 -1 -1 -1 5 5 5 25 0 0 1 -1 -1 -1 3 0 0 0 0 0 0 0 1 -1 -1 -1 -1 -1 3 0 1 -1 -1 -1 -1 -1 -1 -1 -1 -1 -1 -1 -1 3 0 0 23 5 5 5 -1 -1 -1											
-1 -1 -1 -1 -1 5 5 5 21 0 0 1 -1 -1 -1 -1 2 2 2 2 2 8 0 1 -1 -1 -1 -1 -1 3 0 1 -1 -1 -1 -1 -1 -1 -1 -1 -1 -1 -1 -1 3 0 0 27 5 5 5 -1 -1 -1											
-1 -1 -1 -1 -1 5 5 5 5 8 0 1 -1 -1 -1 -1 -1 -1 -1 -1 -1 3 0 1 -1 -1 -1 -1 -1 3 0 1 -1 -1 -1 -1 -1 -1 -1 -1 -1 -1 -1 -1 3 0 0 23 5 5 5 -1 -1 -1											
-1 -1 -1 -1 -1 -1 -1 -1 -1 3 0 12 -1 -1 -1 -1 -1 -1 -1 -1 -1 3 0 1 -1 -1 -1 -1 -1 13 0 1 -1 -1 -1 -1 -1 -1 -1 -1 -1 -1 -1 -1 13 0 6 5 5 5 5 -1 -1 -1											
-1 -1 -1 -1 -1 -1 -1 -1 -1 3 0 1 -1 -1 -1 -1 -1 -1 -1 -1 -1 3 0 1 -1 -1 -1 -1 -1 3 0 1 -1 -1 -1 -1 -1 -1 -1 -1 -1 -1 -1 -1 3 0 1 -1 -1 -1 -1 -1 -1 -1											
-1 -1 -1 -1 -1 -1 -1 -1 -1 3 0 7 4 4 4 4 4 4 4 4 4 9 0 7 4 4 4 4 4 9 0 7 4 4 4 4 4 4 4 -1 -1 -1 -1 -1 3 0 1 -1 -1 -1 -1 -1 -1 -1																	
-1 -1 -1 -1 -1 -1 -1 -1 -1 3 0 0 0 0 0 0 0 0 0 0 0 0 0 0 0 0 0 0 0 0 0 0 0 0 0 0 0 0 0 1 -1 -1 -1 -1 3 0 1 -1 -1 -1 -1 -1 -1 -1
-1 -1 -1 -1 -1 -1 -1 -1 -1 3 0 6 2 2 2 2 2 2 2 2 10 2 2 2 8 0 6 2 10 2 2 2 2 2 2 2 2 8 0 1 -1 -1 -1 -1 3 0 1 -1 -1 -1 -1 -1 -1 -1
-1 -1 -1 -1 -1 -1 -1 -1 -1 3 0 1 -1 -1 -1 -1 -1 -1 -1 -1 -1 -1 -1 -1 3 0 1 -1 -1 -1 -1 -1 -1 -1 -1 -1 -1 3 0 1 -1 -1 -1 -1 3 0 1 -1 -1 -1 -1 -1 -1 -1
-1 -1 -1 -1 -1 -1 -1 -1 -1 3 0 1 -1 -1 -1 -1 -1 -1 -1 -1 -1 -1 -1 -1 3 0 1 -1 -1 -1 -1 -1 -1 -1 -1 -1 -1 3 0 1 -1 -1 -1 -1 3 0 1 -1 -1 -1 -1 -1 -1 -1
-1 -1 -1 -1 -1 -1 -1 -1 -1 3 0 1 -1 -1 -1 -1 -1 -1 -1 -1 -1 -1 -1 -1 3 0 1 -1 -1 -1 -1 -1 -1 -1 -1 -1 -1 3 0 1 -1 -1 -1 -1 13 0 1 -1 -1 -1 -1 -1 -1 -1
-1 -1 -1 -1 -1 -1 -1 -1 -1 3 0 1 -1 -1 -1 -1 -1 -1 -1 -1 -1 -1 -1 -1 3 0 1 -1 -1 -1 -1 -1 -1 -1 -1 -1 -1 3 0 1 -1 -1 -1 -1 3 0 1 -1 -1 -1 -1 -1 -1 -1
-1 -1 -1 -1 -1 -1 -1 -1 -1 3 0 1 -1 -1 -1 -1 -1 -1 -1 -1 -1 -1 -1 -1 3 0 1 -1 -1 -1 -1 -1 -1 -1 -1 -1 -1 3 0 1 -1 -1 -1 -1 3 0 1 -1 -1 -1 -1 -1 -1 -1
-1 -1 -1 -1 -1 -1 -1 -1 -1 3 0 12 -1 -1 -1 -1 -1 -1 -1 -1 -1 -1 -1 -1 3 0 12 -1 -1 -1 -1 -1 -1 -1 -1 -1 -1 3 0 1 -1 -1 -1 -1 3 0 1 -1 -1 -1 -1 -1 -1 -1
-1 -1 -1 -1 -1 -1 -1 -1 -1 3 0 1 -1 -1 -1 -1 -1 -1 -1 -1 -1 -1 -1 -1 3 0 1 -1 -1 -1 -1 -1 -1 -1 -1 -1 -1 3 0 1 -1 -1 -1 -1 3 0 1 -1 -1 -1 -1 -1 -1 -1
-1 -1 -1 -1 -1 -1 -1 -1 -1 3 0 1 -1 -1 -1 -1 -1 -1 -1 -1 -1 -1 -1 -1 3 0 1 -1 -1 -1 -1 -1 -1 -1 -1 -1 -1 3 0 1 -1 -1 -1 -1 3 0 1 -1 -1 -1 -1 -1 -1 -1
-1 -1 -1 -1 -1 -1 -1 -1 -1 3 0 1 -1 -1 -1 -1 -1 -1 -1 -1 -1 -1 -1 -1 13 0 1 -1 -1 -1 -1 -1 -1 -1 -1 -1 -1 3 0 1 -1 -1 -1 -1 3 0 1 -1 -1 -1 -1 -1 -1 -1
-1 -1 -1 -1 -1 -1 -1 -1 -1 3 0 1 -1 -1 -1 -1 -1 -1 -1 -1 -1 -1 -1 -1 3 0 1 -1 -1 -1 -1 -1 -1 -1 -1 -1 -1 3 0 1 -1 -1 -1 -1 3 0 1 -1 -1 -1 -1 -1 -1 -1
-1 -1 -1 -1 -1 -1 -1 -1 -1 3 0 7 4 4 4 4 4 4 4 4 4 4 4 4 9 0 7 4 4 4 4 4 4 4 4 4 4 9 0 7 4 4 4 4 9 0 1 -1 -1 -1 -1 -1 -1 -1								
-1 -1 -1 -1 -1 -1 -1 -1 -1 3 0 0 0 0 0 0 0 0 0 0 0 0 0 0 0 0 0 0 0 0 0 0 0 0 0 0 0 0 0 0 0 0 0 0 0 0 1 -1 -1 -1 -1 -1 -1 -1 		
-1 -1 -1 -1 -1 -1 -1 -1 -1 -1 2 2 2 2 2 2 2 2 2 2 2 2 2 8 0 0 0 6 2 2 2 2 2 2 2 2 2 2 2 2 2 2 2 2 2 2 -1 -1 -1 -1 -1 -1 -1 -1  																					
-1 -1 -1 -1 -1 -1 -1 -1 -1 -1 -1 -1 -1 -1 -1 -1 -1 -1 -1 -1 -1 -1 -1 5 22 26 22 5 -1 -1 -1 -1 -1 -1 -1 -1 -1 -1 -1 -1 -1 -1 -1 -1 -1 -1 -1 -1 -1 -1 -1 -1 -1 -1
-1 -1 -1 -1 -1 -1 -1 -1 -1 -1 -1 -1 -1 -1 -1 -1 -1 -1 -1 -1 -1 -1 -1 5 5 5 5 5 -1 -1 -1 -1 -1 -1 -1 -1 -1 -1 -1 -1 -1 -1 -1 -1 -1 -1 -1 -1 -1 -1 -1 -1 -1 -1
-1 -1 -1 -1 -1 -1 -1 -1 -1 -1 -1 -1 -1 -1 -1 -1 -1 -1 -1 -1 -1 -1 -1 5 5 5 5 5 -1 -1 -1 -1 -1 -1 -1 -1 -1 -1 -1 -1 -1 -1 -1 -1 -1 -1 -1 -1 -1 -1 -1 -1 -1 -1
-1 -1 -1 -1 -1 -1 -1 -1 -1 -1 -1 -1 -1 -1 -1 -1 -1 -1 -1 -1 -1 -1 -1 5 5 5 5 5 -1 -1 -1 -1 -1 -1 -1 -1 -1 -1 -1 -1 -1 -1 -1 -1 -1 -1 -1 -1 -1 -1 -1 -1 -1 -1	
Gym
17 28
-1 -1 -1 -1 -1 -1 -1 -1 -1 -1 -1 5 5 5 5 5 -1 -1 -1 -1 -1 -1 -1 -1 -1 -1 -1 -1
-1 -1 -1 -1 -1 -1 -1 -1 -1 -1 -1 5 5 5 5 5 -1 -1 -1 -1 -1 -1 -1 -1 -1 -1 -1 -1
-1 -1 -1 -1 -1 -1 -1 -1 -1 -1 -1 5 5 5 5 5 -1 -1 -1 -1 -1 -1 -1 -1 -1 -1 -1 -1
-1 -1 -1 -1 -1 -1 -1 -1 -1 -1 -1 5 24 28 24 5 -1 -1 -1 -1 -1 -1 -1 -1 -1 -1 -1 -1
-1 -1 -1 -1 4 4 4 4 4 4 4 9 0 0 0 7 4 4 4 4 4 4 4 4 -1 -1 -1 -1
-1 -1 -1 3 0 0 0 0 0 0 0 0 0 0 0 0 0 0 0 0 0 0 0 0 1 -1 -1 -1
-1 -1 -1 3 0 0 0 0 0 0 0 0 0 0 0 0 0 0 0 0 0 0 20 0 1 -1 -1 -1
-1 -1 -1 3 0 0 0 0 0 0 0 0 20 0 0 0 0 0 0 0 0 0 20 0 1 -1 -1 -1
-1 -1 -1 3 0 0 0 0 0 0 0 0 20 0 0 20 0 0 0 0 0 0 20 0 1 -1 -1 -1
-1 -1 -1 3 0 0 0 0 0 0 0 0 20 0 0 20 0 0 0 20 0 0 20 0 1 -1 -1 -1
-1 -1 -1 13 0 0 0 0 0 0 0 0 0 0 0 20 0 0 0 20 0 0 0 0 12 -1 -1 -1
-1 -1 -1 3 0 0 19 19 19 19 0 0 0 0 0 0 0 0 0 20 0 0 0 0 1 -1 -1 -1
-1 -1 -1 3 0 0 0 0 0 0 0 0 0 0 0 0 0 0 0 20 0 0 0 0 1 -1 -1 -1
-1 -1 -1 3 0 0 0 0 0 0 0 0 0 0 0 0 0 0 0 0 0 0 0 0 1 -1 -1 -1
-1 -1 -1 3 0 0 19 19 19 0 19 19 19 19 0 0 19 19 0 19 19 19 0 0 1 -1 -1 -1
-1 -1 -1 3 19 19 19 0 0 0 0 0 0 0 0 0 0 0 0 0 0 0 0 0 1 -1 -1 -1
-1 -1 -1 -1 2 2 2 2 2 2 2 2 2 2 2 2 2 2 2 2 2 2 2 2 -1 -1 -1 -1
Room1
11 15
-1 -1 -1 -1 -1 -1 -1 -1 -1 -1 -1 -1 -1 -1 -1
-1 -1 4 4 4 4 4 4 4 4 4 4 4 -1 -1
-1 3 0 0 0 0 0 0 0 0 0 0 0 1 -1 
-1 3 0 0 0 0 0 18 0 18 0 0 0 1 -1 
-1 3 0 0 16 0 0 18 0 18 0 0 0 1 -1 
-1 3 0 0 16 0 0 0 0 0 0 0 0 12 -1 
-1 3 0 0 0 0 0 0 18 0 18 0 0 1 -1 
-1 3 0 0 0 0 0 0 18 0 18 0 0 1 -1 
-1 3 0 0 0 0 0 0 0 0 0 0 0 1 -1 
-1 -1 2 2 2 2 2 2 2 2 2 2 2 -1 -1 
-1 -1 -1 -1 -1 -1 -1 -1 -1 -1 -1 -1 -1 -1 -1
Room2
13 20
-1 -1 -1 -1 -1 -1 -1 -1 -1 -1 -1 -1 -1 -1 -1 -1 -1 -1 -1 -1 
-1 -1 4 4 4 4 4 4 4 4 4 4 4 4 4 4 4 4 -1 -1
-1 3 0 0 0 0 0 0 0 0 0 0 0 0 0 0 0 0 1 -1 
-1 3 0 0 0 0 0 0 0 0 0 0 0 0 0 0 0 0 1 -1 
-1 3 0 0 0 0 0 0 0 0 0 0 0 0 0 0 0 0 1 -1 
-1 3 0 0 0 16 0 0 0 0 0 0 0 0 0 0 0 0 1 -1 
-1 3 0 0 0 16 0 0 0 0 0 0 0 0 0 0 0 0 12 -1 
-1 3 0 0 0 16 0 0 0 0 0 0 0 0 0 0 0 0 1 -1 
-1 3 0 0 0 0 0 0 0 0 0 0 0 0 0 0 0 0 1 -1 
-1 3 0 0 0 0 0 0 0 0 0 0 0 0 0 0 0 0 1 -1 
-1 3 0 0 0 0 0 0 0 0 0 0 0 0 0 0 0 0 1 -1 
-1 -1 2 2 2 2 2 2 2 2 2 2 2 2 2 2 2 2 -1 -1 
-1 -1 -1 -1 -1 -1 -1 -1 -1 -1 -1 -1 -1 -1 -1 -1 -1 -1 -1 -1 
Room3
11 15
-1 -1 -1 -1 -1 -1 -1 -1 -1 -1 -1 -1 -1 -1 -1
-1 -1 4 4 4 4 4 4 4 4 11 4 4 -1 -1
-1 3 0 0 0 18 0 0 0 0 0 0 0 1 -1 
-1 3 0 0 0 18 0 18 18 18 0 0 0 1 -1 
-1 3 0 16 0 0 0 0 0 0 18 0 0 1 -1 
-1 3 0 16 0 18 0 18 0 18 0 0 0 1 -1 
-1 3 0 16 0 0 0 0 0 0 0 0 0 1 -1 
-1 3 0 0 0 18 18 18 0 18 0 0 0 1 -1 
-1 3 0 0 0 0 0 0 0 0 0 0 0 1 -1 
-1 -1 2 2 2 2 2 2 2 2 2 2 2 -1 -1 
-1 -1 -1 -1 -1 -1 -1 -1 -1 -1 -1 -1 -1 -1 -1
Room4
13 20
-1 -1 -1 -1 -1 -1 -1 -1 -1 -1 -1 -1 -1 -1 -1 -1 -1 -1 -1 -1 
-1 -1 4 4 4 4 4 4 4 4 4 4 4 4 4 4 4 4 -1 -1
-1 3 0 0 0 0 0 0 0 0 0 0 0 0 0 0 0 0 1 -1 
-1 3 0 0 0 0 0 0 0 0 0 0 0 0 0 0 0 0 1 -1 
-1 3 0 0 0 0 0 0 0 0 0 0 0 0 16 0 0 0 1 -1 
-1 3 0 0 0 0 0 0 0 0 0 0 0 0 18 0 0 0 1 -1 
-1 3 0 0 0 0 0 0 0 0 0 0 0 0 16 0 0 0 1 -1 
-1 3 0 0 0 0 0 0 0 0 0 0 0 0 18 0 0 0 1 -1 
-1 13 0 0 0 0 0 0 0 0 0 0 0 0 0 0 0 0 1 -1 
-1 3 0 0 0 0 0 0 0 0 0 0 0 0 0 0 0 0 1 -1 
-1 3 0 0 0 0 0 0 0 0 0 0 0 0 0 0 0 0 1 -1 
-1 -1 2 2 2 2 2 2 2 2 2 2 2 2 2 2 2 2 -1 -1 
-1 -1 -1 -1 -1 -1 -1 -1 -1 -1 -1 -1 -1 -1 -1 -1 -1 -1 -1 -1 
Room5
13 20
-1 -1 -1 -1 -1 -1 -1 -1 -1 -1 -1 -1 -1 -1 -1 -1 -1 -1 -1 -1 
-1 -1 4 4 4 4 4 4 4 4 4 4 4 4 4 4 4 4 -1 -1
-1 3 0 0 0 0 0 0 0 0 0 0 0 16 0 17 17 17 1 -1 
-1 3 0 0 0 17 17 17 0 0 0 0 0 16 0 0 0 0 1 -1 
-1 3 0 0 0 0 0 0 0 0 0 0 0 16 0 0 0 0 1 -1 
-1 3 0 0 0 0 0 0 0 0 0 0 0 16 0 0 0 0 1 -1 
-1 13 0 0 0 0 0 0 0 0 0 0 0 0 0 0 0 0 1 -1 
-1 3 0 0 0 0 0 0 0 0 0 0 18 0 18 0 0 0 1 -1 
-1 3 0 0 0 0 0 0 0 0 0 0 18 0 18 0 0 0 1 -1 
-1 3 0 0 0 0 0 16 0 0 0 0 18 0 18 0 0 0 1 -1 
-1 3 0 0 0 0 0 16 0 0 0 0 0 0 0 0 0 0 1 -1 
-1 -1 2 2 2 2 2 2 2 2 2 2 2 2 2 2 2 2 -1 -1 
-1 -1 -1 -1 -1 -1 -1 -1 -1 -1 -1 -1 -1 -1 -1 -1 -1 -1 -1 -1 
Room6
11 15
-1 -1 -1 -1 -1 -1 -1 -1 -1 -1 -1 -1 -1 -1 -1
-1 -1 4 4 4 4 4 4 4 4 4 4 4 -1 -1
-1 3 0 16 0 0 0 0 0 0 0 0 0 1 -1 
-1 3 0 16 0 15 15 0 0 0 18 0 18 1 -1 
-1 3 0 16 0 0 0 0 0 0 0 0 18 1 -1 
-1 3 0 0 0 0 0 0 18 0 0 0 0 12 -1 
-1 3 0 0 0 0 0 0 18 0 0 0 0 1 -1 
-1 3 0 15 15 15 0 0 15 15 15 0 0 1 -1 
-1 3 0 0 0 0 0 0 0 0 0 0 0 1 -1 
-1 -1 2 2 2 2 2 2 2 2 2 2 2 -1 -1 
-1 -1 -1 -1 -1 -1 -1 -1 -1 -1 -1 -1 -1 -1 -1
Room7
13 20
-1 -1 -1 -1 -1 -1 -1 -1 -1 -1 -1 -1 -1 -1 -1 -1 -1 -1 -1 -1 
-1 -1 4 4 4 4 4 4 4 4 4 4 4 4 4 4 4 4 -1 -1
-1 3 0 0 0 0 0 0 0 0 0 0 0 0 0 0 0 0 1 -1 
-1 3 0 0 18 0 18 0 18 0 18 0 18 0 18 0 18 0 1 -1 
-1 3 0 0 0 0 0 0 0 0 0 0 0 0 0 0 0 0 1 -1 
-1 3 16 0 18 0 18 0 18 0 18 0 18 0 18 0 18 0 1 -1 
-1 3 16 0 18 0 0 0 0 0 0 0 0 0 0 0 0 0 12 -1 
-1 3 16 0 18 0 18 0 18 0 18 0 18 0 18 0 18 0 1 -1 
-1 3 0 0 0 0 0 0 0 0 0 0 0 0 0 0 0 0 1 -1 
-1 3 0 0 18 0 18 0 18 0 18 0 18 0 18 0 18 0 1 -1 
-1 3 0 0 0 0 0 0 0 0 0 0 0 0 0 0 0 0 1 -1 
-1 -1 2 2 2 2 2 2 2 2 2 2 2 2 2 2 2 2 -1 -1 
-1 -1 -1 -1 -1 -1 -1 -1 -1 -1 -1 -1 -1 -1 -1 -1 -1 -1 -1 -1 
Room8
14 12
-1 -1 -1 -1 -1 -1 -1 -1 -1 -1 -1 -1
-1 -1 4 4 4 4 4 4 4 4 -1 -1
-1 3 0 0 0 0 0 0 0 0 1 -1
-1 3 0 0 0 0 0 16 0 0 12 -1
-1 3 0 0 0 0 0 16 0 0 1 -1
-1 13 0 15 15 0 0 16 0 0 1 -1
-1 3 0 0 0 0 0 15 0 0 1 -1
-1 3 0 0 16 0 0 15 0 0 1 -1
-1 3 0 0 16 0 0 0 0 0 1 -1
-1 3 0 0 0 0 0 0 0 0 1 -1
-1 3 0 17 17 17 0 16 0 0 1 -1
-1 3 0 0 0 0 0 16 0 0 1 -1
-1 3 0 0 0 0 0 0 0 0 1 -1
-1 -1 2 2 2 2 2 2 2 2 -1 -1
Room9
14 12
-1 -1 -1 -1 -1 -1 -1 -1 -1 -1 -1 -1
-1 -1 4 4 4 4 4 4 11 4 -1 -1
-1 3 0 0 0 0 0 0 0 0 1 -1
-1 3 0 0 0 0 0 16 0 0 1 -1
-1 3 0 0 0 0 0 16 0 0 1 -1
-1 3 0 15 15 0 0 16 0 0 1 -1
-1 3 0 0 0 0 0 15 0 0 1 -1
-1 3 0 0 16 0 0 15 0 0 1 -1
-1 3 0 0 16 0 0 0 0 0 1 -1
-1 3 0 0 0 0 0 0 0 0 1 -1
-1 13 0 17 17 17 0 16 0 0 1 -1
-1 3 0 0 0 0 0 16 0 0 1 -1
-1 3 0 0 0 0 0 0 0 0 1 -1
-1 -1 2 2 2 2 2 2 2 2 -1 -1
Room10
9 16
-1 -1 -1 -1 -1 -1 -1 -1 -1 -1 -1 -1 -1 -1 -1 -1
-1 -1 4 4 4 4 4 4 4 4 4 4 4 4 -1 -1
-1 3 0 0 0 0 0 0 0 0 0 0 0 0 1 -1 
-1 3 0 0 0 0 17 17 17 0 0 0 0 0 1 -1 
-1 3 0 0 0 0 0 0 0 18 0 0 0 0 1 -1 
-1 3 0 0 0 0 0 0 0 18 0 0 0 0 1 -1 
-1 3 0 0 0 0 15 15 15 0 0 0 0 0 12 -1 
-1 3 0 0 0 0 0 0 0 0 0 0 0 0 1 -1 
-1 -1 2 2 2 2 2 2 2 2 2 2 2 2 -1 -1
Room11
13 14
-1 -1 -1 -1 -1 -1 -1 -1 -1 -1 -1 -1 -1 -1
-1 -1 4 11 4 4 4 4 4 4 4 4 -1 -1
-1 3 0 0 0 0 0 15 16 0 0 0 1 -1 
-1 3 18 0 15 0 0 0 0 17 0 0 1 -1 
-1 3 0 0 0 0 16 0 0 0 0 0 1 -1 
-1 3 0 18 17 18 0 0 16 0 17 0 1 -1 
-1 3 0 0 0 16 0 0 0 0 15 0 1 -1 
-1 3 0 17 0 0 0 17 0 0 0 0 1 -1 
-1 3 0 0 0 0 0 0 0 15 0 0 1 -1 
-1 3 0 0 18 0 0 18 0 0 0 16 1 -1 
-1 3 0 0 0 0 16 0 0 17 0 0 1 -1 
-1 3 0 0 0 15 0 0 0 0 18 15 1 -1 
-1 -1 2 2 2 2 2 2 2 2 2 2 -1 -1
Room12
9 16
-1 -1 -1 -1 -1 -1 -1 -1 -1 -1 -1 -1 -1 -1 -1 -1
-1 -1 4 4 4 4 4 4 4 4 4 4 4 4 -1 -1
-1 3 0 0 16 0 0 0 0 16 0 0 0 0 1 -1 
-1 13 0 0 0 0 16 0 0 0 0 0 18 0 1 -1 
-1 3 0 0 16 0 0 0 0 16 0 0 18 0 1 -1 
-1 3 16 0 0 0 16 0 0 0 0 0 18 0 1 -1 
-1 3 0 0 16 0 0 0 0 16 0 0 0 0 1 -1 
-1 3 16 0 0 0 16 0 0 0 0 0 0 0 1 -1 
-1 -1 2 2 2 2 2 2 2 2 2 2 2 2 -1 -1
Room13
15 12
-1 -1 -1 -1 -1 -1 -1 -1 -1 -1 -1 -1
-1 -1 4 4 4 4 4 4 4 4 -1 -1
-1 3 0 0 0 0 0 0 0 0 1 -1
-1 3 0 0 17 17 17 0 0 0 12 -1
-1 3 0 17 0 0 0 17 0 0 1 -1
-1 3 0 17 0 0 0 17 17 0 1 -1
-1 3 0 17 17 17 17 17 17 0 1 -1
-1 3 0 17 0 0 0 17 17 0 1 -1
-1 3 0 17 17 17 17 17 17 0 1 -1
-1 3 0 17 0 0 0 17 0 0 1 -1
-1 3 0 0 0 0 0 0 0 0 1 -1
-1 3 0 0 0 0 0 0 0 0 1 -1
-1 3 0 0 0 0 0 0 0 0 1 -1
-1 3 0 0 0 0 0 0 0 0 1 -1
-1 -1 2 2 2 2 2 2 2 2 -1 -1